[
  {
    "map": [
      [ 0, 0, 0, 0, 0, 0, 0, 0, 0, 0 ],
      [ 0, 0, 0, 0, 0, 0, 0, 0, 0, 0 ],
      [ 0, 0, 0, 0, 0, 0, 0, 0, 0, 0 ],
      [ 0, 0, 0, 3, 3, 3, 3, 0, 0, 0 ],
      [ 0, 0, 0, 3, 3, 3, 3, 0, 0, 0 ],
      [ 0, 0, 0, 3, 3, 3, 3, 0, 0, 0 ],
      [ 0, 0, 0, 3, 3, 3, 3, 0, 0, 0 ],
      [ 0, 0, 0, 0, 0, 0, 0, 0, 0, 0 ],
      [ 0, 0, 0, 0, 0, 0, 0, 0, 0, 0 ],
      [ 0, 0, 0, 0, 0, 0, 0, 0, 0, 0 ]
    ]
  },
  {
    "map": [
      [ 0, 0, 0, 0, 0, 0, 0, 0, 0, 0 ],
      [ 0, 0, 0, 0, 0, 0, 0, 0, 0, 0 ],
      [ 0, 0, 0, 0, 0, 0, 0, 0, 0, 0 ],
      [ 0, 0, 0, 3, 3, 3, 3, 0, 0, 0 ],
      [ 0, 0, 0, 3, 20, 10, 3, 0, 0, 0 ],
      [ 0, 0, 0, 3, 10, 20, 3, 0, 0, 0 ],
      [ 0, 0, 0, 3, 3, 3, 3, 0, 0, 0 ],
      [ 0, 0, 0, 0, 0, 0, 0, 0, 0, 0 ],
      [ 0, 0, 0, 0, 0, 0, 0, 0, 0, 0 ],
      [ 0, 0, 0, 0, 0, 0, 0, 0, 0, 0 ]
    ]
  },
  {
    "map": [
      [ 0, 0, 0, 0, 0, 0, 0, 0, 0, 0 ],
      [ 0, 0, 0, 0, 0, 0, 0, 0, 0, 0 ],
      [ 0, 0, 0, 0, 0, 0, 0, 0, 0, 0 ],
      [ 0, 0, 0, 10, 3, 3, 10, 0, 0, 0 ],
      [ 0, 0, 0, 10, 20, 20, 10, 0, 0, 0 ],
      [ 0, 0, 0, 11, 21, 21, 11, 0, 0, 0 ],
      [ 0, 0, 0, 11, 3, 3, 11, 0, 0, 0 ],
      [ 0, 0, 0, 0, 0, 0, 0, 0, 0, 0 ],
      [ 0, 0, 0, 0, 0, 0, 0, 0, 0, 0 ],
      [ 0, 0, 0, 0, 0, 0, 0, 0, 0, 0 ]
    ]
  },
  {
    "map": [
      [ 0, 0, 0, 0, 0, 0, 0, 0, 0, 0 ],
      [ 0, 0, 0, 0, 0, 0, 0, 0, 0, 0 ],
      [ 0, 0, 0, 0, 3, 3, 0, 0, 0, 0 ],
      [ 0, 0, 0, 20, 10, 10, 20, 0, 0, 0 ],
      [ 0, 0, 3, 10, 3, 3, 10, 3, 0, 0 ],
      [ 0, 0, 3, 11, 3, 3, 11, 3, 0, 0 ],
      [ 0, 0, 0, 21, 11, 11, 21, 0, 0, 0 ],
      [ 0, 0, 0, 0, 3, 3, 0, 0, 0, 0 ],
      [ 0, 0, 0, 0, 0, 0, 0, 0, 0, 0 ],
      [ 0, 0, 0, 0, 0, 0, 0, 0, 0, 0 ]
    ]
  }
]
